10 10
5 1
7 2
2 4 2 1 4 5 2 4 3 1
0 1 2 3 5 3 1 1 0 4
2 0 4 4 1 2 4 5 3 2
2 5 5 3 2 0 1 1 5 2
4 3 3 2 1 4 1 2 4 4
4 3 1 2 4 2 3 1 3 2
5 3 2 3 2 3 2 0 2 1
2 4 4 2 5 1 3 2 4 1
4 2 1 5 3 1 5 2 0 0
0 5 2 1 3 2 0 1 3 4
