5 5
3 2
4 1
2 4 2 1 4
0 1 2 3 5
2 0 4 4 1
2 5 5 3 2
4 3 3 2 1
